WMXXoMcXBXXXXXXXBXcMoXXMW
MMXXXMXXBXXXXXXXBXXMXXXMM
XXXXXMXXBXXXXXXXBXXMXXXXX
XXXXXMXXBXXXXXXXBXXMXXXXX
XXXXXMXXBXXXXXXXBXXMXXXXX
XXXXXXXXXXXXXXXXXXXXXXXXX
XXXXXXXXXXXXXXXXXXXXXXXXX
XXXXXXXXXXXXXXXXXXXXXXXXX
XXXXXXXXXXXXXXXXXXXXXXXXX
XXXXXXXXXXXXXXXXXXXXXXXXX
BBBBBBBBBBBBBBBBBBBBBBBBB
XXXXXXXXXXXXXXXXXXXXXXXXX
XXXXXXXXXXXXXXXXXXXXXXXXX
XXXXXXXXXXXXXXXXXXXXXXXXX
XXXXXXXXXXXXXXXXXXXXXXXXX
BXXXXXXXXXXXXXXXXXXXXXXXB
BBXXXXXXXXXXXXXXXXXXXXXBB
BBBXXXXXXXXXXXXXXXXXXXBBB
MMBBXXXXXXXXBBBXXXXXXBBMM
WMBBBXXXXXPXBFBXXXXXBBBMW
