OXXXMXXXAXXXMXXXAXXXMXXXc
XXXXMXXXXXXXMXXXXXXXMXXXX
XXXXMXXXXXXXMXXXXXXXMXXXX
XXXXMXXXXXXXMXXXXXXXMXXXX
XXXXMXXXXXXXMXXXXXXXMXXXX
XXXXXXXXXXXXXXXXXXXXXXXXX
BBBBBBBBBBBBBBBBBBBBBBBBB
BBMMBBBBBBBBBBBBBBBBBMMBB
BBMMBBBBBBBMMMBBBBBBBMMBB
BBMMBBBBBBBMMMBBBBBBBMMBB
BBMMBBBBBBBMMMBBBBBBBMMBB
BBMMBBBBBBBBBBBBBBBBBMMBB
BBBBBBBBBBBBBBBBBBBBBBBBB
XXXXXXXXXXXXXXXXXXXXXXXXX
XXXXXXXXXXXXXXXXXXXXXXXXX
XXXXXXXXXXXXXXXXXXXXXXXXX
XXXXXXXXXXXXXXXXXXXXXXXXX
XXXXXXXXXXXXXXXXXXXXXXXXX
XXXXXXXXXXXBBBXXXXXXXXXXX
XXXXXXXXPXXBFBXXXXXXXXXXX