AMXXXXXMCMXXXXXMCMXXXXXMA
XMXXXXXMXMXXXXXMXMXXXXXMX
XMXXXXXMXMXXXXXMXMXXXXXMX
XMWWWWWMXMWWWWWMXMWWWWWMX
XMBBBBBMXMBBBBBMXMBBBBBMX
XMWWWWWMXMXXXXXMXMWWWWWMX
XMBBBBBMXMXXXXXMXMBBBBBMX
XMMMMMMMXMXXXXXMXMMMMMMMX
XMBBBBBMXMXXXXXMXMBBBBBMX
XMWWWWWMXMXMMMXMXMWWWWWMX
XMBBBBBMXMXMMMXMXMBBBBBMX
XMMMMMMMXMXMMMXMXMMMMMMMX
XMBBBBBMXMXMMMXMXMBBBBBMX
XMWWWWWMXMXMMMXMXMWWWWWMX
XMBBBBBMXMXMMMXMXMBBBBBMX
BMMMMMMMBMBBBBBMBMMMMMMMB
XXXXXXXMXXXXXXXXXMXXXXXXX
MMMMMXXMMMMMXMMMMMXXMMMMM
MMXXXXXXXXXXXXXXXXXXXXXMM
WMXXXXXXPXXXFXXXXXXXXXXMW