AMXXXXXMcMXXXXXMcMXXXXXMA
XMXXXXXMXMXXXXXMXMXXXXXMX
XMXXXXXMXMXXXXXMXMXXXXXMX
XMWWWWWMXMWWWWWMXMWWWWWMX
XMBBBBBMXMBBBBBMXMBBBBBMX
XMMMMMMMXMMMMMMMXMMMMMMMX
XXXXXXXXXXXXXXXXXXXXXXXXX
MMMXXXXXXXXXXXXXXXXXXXMMM
XXMXXMMXXXXXXXXXXXMMXXMXX
XXMXXMXXXXMMXMMXXXXMXXMXX
XXMXXMXXXXXMMMXXXXXMXXMXX
XXMXXMXXXMXXMXXMXXXMXXMXX
XXMXXMMXXMMMMMMMXXMMXXMXX
XXMXXXXXXXXXXXXXXXXXXXMXX
XXMMMMXXXXXXXXXXXXXMMMMXX
XXXXXMBBBMMMMMMMBBBMXXXXX
WWWWMMXXXXXXXXXXXXXMMWWWW
MMMMMMXXXXXXXXXXXXXMMMMMM
MMXXXXXXXXXBBBXXXXXXXXXMM
WMXXXXXXPXXBFBXXXXXXXXXMW