CXXXMXXXAXXXMXXXAXXXMXXXC
XXXXMXXXXXXXMXXXXXXXMXXXX
XXXXMXXXXXXXMXXXXXXXMXXXX
XXXXMXXXXXXXMXXXXXXXMXXXX
XXXXMXXXXXXXMXXXXXXXMXXXX
XXXXXXXXXXXXXXXXXXXXXXXXX
XXXXXXXXXXXXXXXXXXXXXXXXX
XXXXXXXXXXXXXXXXXXXXXXXXX
MMMMMMMMXXXXXXXXXMMMMMMMM
WWWWWWMMBBBBBBBBBMMWWWWWW
WWWWWWMMXXXXXXXXXMMWWWWWW
MMMMMMMMXXXXXXXXXMMMMMMMM
BBBBBBBBBBBBBBBBBBBBBBBBB
BBBBBBBBBBBBBBBBBBBBBBBBB
MMMMMMMMXXXXXXXXXMMMMMMMM
XXXBBBBBXXXXXXXXXBBBBBXXX
XXXBBXXXXXXXXXXXXXXXBBXXX
XXXBBXXXXXXXXXXXXXXXBBXXX
XXXBBXXXXXXBBBXXXXXXBBXXX
XXXXXXXXPXXBFBXXXXXXXXXXX