CXXXMXXXAXXXMXXXAXXXMXXXC
XXXXMXXXXXXXMXXXXXXXMXXXX
XXXXMXXXXXXXMXXXXXXXMXXXX
XXXXMXXXXXXXMXXXXXXXMXXXX
XXXXMXXXXXXXMXXXXXXXMXXXX
XXXXXXXXXXXXXXXXXXXXXXXXX
XXXXXXXXXXXXXXXXXXXXXXXXX
MMMXXMBBBBBBBBBBBBBMXXMMM
MXXXXMWWWWWWWWWWWWWMXXXXM
MXXMMMXXXXXXMXXXXXXMMMXXM
MXXMXXXXXXXMMMXXXXXXXMXXM
MXXMXXXXXXMMMMMXXXXXXMXXM
MXXMXXXXXXXMMMXXXXXXXMXXM
MXXMXXXXXXXXMXXXXXXXXMXXM
MXXMMMWWWWWWWWWWWWWMMMXXM
MMXXXMBBBBBBBBBBBBBMXXXMM
XXXXXXXXXXXXXXXXXXXXXXXXX
XXXXXXXXXXXXXXXXXXXXXXXXX
XXXXXXXXXXXBBBXXXXXXXXXXX
XXXXXXXXPXXBFBXXXXXXXXXXX