AMXXXXXMCMXXXXXMCMXXXXXMA
XMXXXXXMXMXXXXXMXMXXXXXMX
XMXXXXXMXMXXXXXMXMXXXXXMX
XMWWWWWMXMWWWWWMXMWWWWWMX
XMBBBBBMXMBBBBBMXMBBBBBMX
XMXXXXXMXMXXXXXMXMXXXXXMX
XMXXXXXMXMXXXXXMXMXXXXXMX
XXXXXXXXXXXXXXXXXXXXXXXXX
XMXXXXXMXMXXXXXMXMXXXXXMX
XMXXXXXMXMXMMMXMXMXXXXXMX
XMXXXXXMXMXMMMXMXMXXXXXMX
XXXXXXXXXXXMMMXXXXXXXXXXX
XMXXXXXMXMXMMMXMXMXXXXXMX
XMXXXXXMXMXMMMXMXMXXXXXMX
XMXXXXXMXMXMMMXMXMXXXXXMX
BMBBBBBMBMBBBBBMBMBBBBBMB
XXXXXXXXXXXXXXXXXXXXXXXXX
XXXXXXXXXXXXXXXXXXXXXXXXX
MMXXXXXXXXXBBBXXXXXXXXXMM
WMXXXXXXPXXBFBXXXXXXXXXMW