AMXXXXXMcMXXXXXMcMXXXXXMA
XMXXXXXMXMXXXXXMXMXXXXXMX
XMXXXXXMXMXXXXXMXMXXXXXMX
XMWWWWWMXMWWWWWMXMWWWWWMX
XMBBBBBMXMBBBBBMXMBBBBBMX
XXXXXXXXXXXXXXXXXXXXXXXXX
XXXXXXXXXXXXXXXXXXXXXXXXX
BBBBBMMMMXXXXXXXMMMMBBBBB
MMMMMMXXXXXXXXXXXXXMMMMMM
XXXXXMXXXMMMMMMMXXXMXXXXX
XXXXXMXXXMWWMWWMXXXMXXXXX
XXXXXMXXXMBBMBBMXXXMXXXXX
XXXXXMXXXMMMMMMMXXXMXXXXX
XXXXXMXXXMWWMWWMXXXMXXXXX
XXXXXMXXXMBBMBBMXXXMXXXXX
XXXXXMXXXMWWMWWMXXXMXXXXX
XXXXXMXXXMMMMMMMXXXMXXXXX
XXXXXMXXXXXXXXXXXXXMXXXXX
XXXXXMMMXXXBBBXXXMMMXXXXX
XXXXXXXXPXXBFBXXXXXXXXXXX