AMXXXXXMCMXXXXXMCMXXXXXMA
XMXXXXXMXMXXXXXMXMXXXXXMX
XMXXXXXMXMXXXXXMXMXXXXXMX
XMWWWWWMXMWWWWWMXMWWWWWMX
XMBBBBBMXMBBBBBMXMBBBBBMX
XMXXXXXMXMXXXXXMXMXXXXXMX
XMXXXXXMXMXXXXXMXMXXXXXMX
XMMMMMMMXMXXXXXMXMMMMMMMX
XMBBBBBMXMXXXXXMXMBBBBBMX
XMWWWWWMXMXMMMXMXMWWWWWMX
XMBBBBBMXMXMMMXMXMBBBBBMX
XMMMMMMMXMXMMMXMXMMMMMMMX
XMXXXXXMXMXMMMXMXMXXXXXMX
XMXXXXXMXMXMMMXMXMXXXXXMX
XMXXXXXMXMXMMMXMXMXXXXXMX
BMBBBBBMBMBBBBBMBMBBBBBMB
XXXXXXXXXXXXXXXXXXXXXXXXX
MMMMMXXXXXXXXXXXXXXXMMMMM
MMXXXXXXXXXBBBXXXXXXXXXMM
WMXXXXXXPXXBFBXXXXXXXXXMW