cXXXMXXXAXXXMXXXAXXXMXXXc
XXXXMXXXXXXXMXXXXXXXMXXXX
XXXXMXXXXXXXMXXXXXXXMXXXX
XXXXMXXXXXXXMXXXXXXXMXXXX
XXXXMXXXXXXXMXXXXXXXMXXXX
XXXXXXXXXXXXXXXXXXXXXXXXX
XXXXXXXXXXXXXXXXXXXXXXXXX
MMBBBBBBBBBBBBBBBBBBBBBMM
MMBBBBBBBBBMMMBBBBBBBBBMM
WWBBBBBBBBBMMMBBBBBBBBBWW
MMBBBBBBBBBMMMBBBBBBBBBMM
MMBBBBBBBBBBBBBBBBBBBBBMM
XXXXXXXXXXXXXXXXXXXXXXXXX
XXXXXXXXXXXXXXXXXXXXXXXXX
XXXXXXXXXXXXXXXXXXXXXXXXX
XXXXXXXXXXXXXXXXXXXXXXXXX
XXXXXXXXXXXXXXXXXXXXXXXXX
XXXXXXXXXXXXXXXXXXXXXXXXX
XXXXXXXXXXXBBBXXXXXXXXXXX
XXXXXXXXPXXBFBXXXXXXXXXXX