OXXXMXXXOXXXMXXXOXXXMXXXO
XXXXMXXXXXXXMXXXXXXXMXXXX
XXXXMXXXXXXXMXXXXXXXMXXXX
XXXXMXXXXXXXMXXXXXXXMXXXX
XXXXMXXXXXXXMXXXXXXXMXXXX
XXXXXXXXXXXXXXXXXXXXXXXXX
BBBBBBBBBBBBBBBBBBBBBBBBB
BBBBBBBBBBBBBBBBBBBBBBBBB
MBBBBBBBBBBMBMBBBBBBBBBBM
MMMBBBBBMMMMMMMMMBBBBBMMM
MBBBBBBBBBBMBMBBBBBBBBBBM
BBBBBBBBBBBBBBBBBBBBBBBBB
BBBBBBBBBBBBBBBBBBBBBBBBB
XXXXXXXXXXXXXXXXXXXXXXXXX
XXXXXXXXXXXXXXXXXXXXXXXXX
XXXXXXXXXXXXXXXXXXXXXXXXX
XXXXXXXXXXXXXXXXXXXXXXXXX
XXXXXXXXXXXXXXXXXXXXXXXXX
XXXXXXXXXXXBBBXXXXXXXXXXX
XXXXXXXXPXXBFBXXXXXXXXXXX