WMXXXXXXXXBFBXPXXXXXXXXMW
MMXXXXXXXXBBBXXXXXXXXXXMM
XXXXXXXXXXXXXXXXXXXXXXXXX
XXXXXXXXXXXXXXXXXXXXXXXXX
XXXXXXXXXXXXXXXXXXXXXXXXX
BBBBBBBBBBBBBBBBBBBBBBBBB
WWWWWWWWWWWWWWWWWWWWWWWWW
XXXXXXXXXMMMMMXXXXXXXXXXX
XXXXXXXXXBMMMBXXXXXXXXXXX
XXXXXXXXXBBMBBXXXXXXXXXXX
XXXXXXXXXBMMMBXXXXXXXXXXX
XXXXXXXXXMMMMMXXXXXXXXXXX
WWWWWWWWWWWWWWWWWWWWWWWWW
BBBBBBBBBBBBBBBBBBBBBBBBB
XXXXXXXXXXXXXXXXXXXXXXXXX
XXXXXXXXXXXXXXXXXXXXXXXXX
XXXXXXXXXXXXXXXXXXXXXXXXX
XXXXXXXXXXXXXXXXXXXXXXXXX
MMXXXXXXXXBBBXXXXXXXXXXMM
WMXXXXXXpXBfBXXXXXXXXXXMW